10 10 5 5 1.0
########################
#EEF..................I#
#EEF...................#
#FFF...................#
#......................#
#......................#
#......................#
#......................#
#......................#
#I.....................#
########################