2 16 14 15 0.3 1.0
XXXXXXXXXXXXXXXXXXXXXXXXXXXXXXXXXXXXXX
XXXXXXXXXXXXXXX#################XXXXXX
XXXXXXXXXXXXXXX#........IIIIIIH#XXXXXX
XXXXXXXXXXXXXXX#........IIIIIIH#XXXXXX
XXXXXXXXXXXXXXX#FF######IIIIIIH#XXXXXX
XXXXXXXXXXXXXXX#FF#XXXX#IIIIIIH#XXXXXX
XXXXXXXXXXXXXXX#FF#XXXX#IIIIIIH#XXXXXX
XXXXXXXXXXXXXXX#FF#XXXX#IIIIIIH#XXXXXX
XXXXXXXXXXXXXXX#FF#XXXX#########XXXXXX
XXXXXXXXXXXXXXX#FF#XXXXXXXXXXXXXXXXXXX
XXXXXXXXXXXXXXX#FF#XXXXXXXXXXXXXXXXXXX
XXXXXXXXXXXXXXX#FF#XXXXXXXXXXXXXXXXXXX
XXXXXXXXXXXXXXX#FF#XXXXXXXXXXXXXXXXXXX
XXXXXXXXXXXXXX##FF#XXXXXXXXXXXXXXXXXXX
XXXXXXXXXXXXXX#.FF#XXXXXXXXXXXXXXXXXXX
XXXXXXXXXXXXXX##EE#XXXXXXXXXXXXXXXXXXX
XXXXXXXXXXXXXXX#EE#XXXXXXXXXXXXXXXXXXX
XXXXXXXXXXXXXXX####XXXXXXXXXXXXXXXXXXX