##############################################################
#............................................................#
#............................................................#
#............................................................#
#............................................................#
#............................................................#
#............................................................#
#............................................................#
#............................................................#
#............................................................#
#............................................................#
#...........................EE...............................#
#...........................EE...............................#
#............................................................#
#............................................................#
#............................................................#
#............................................................#
#............................................................#
#............................................................#
#............................................................#
#............................................................#
#............................................................#
#............................................................#
#............................................................#
#............................................................#
##############################################################