1 1 5 5 0.2 1.0
###########################
#.c................v.v...I#
#.t.......................#
#.........................#
#.........................#
#......................####
#.......................EE#
#.......................EE#
###########################